16 38
00000000000000000000000000000000000000
00000000000000000000000000000000000000
00000000000000000000000000000000000000
00000000000000000000000001000000000000
00000000000000000000000101000000000000
00000000000001100000011000000000000110
00000000000010001000011000000000000110
01100000000100000100011000000000000000
01100000000100010110000101000000000000
00000000000100000100000001000000000000
00000000000010001000000000000000000000
00000000000001100000000000000000000000
00000000000000000000000000000000000000
00000000000000000000000000000000000000
00000000000000000000000000000000000000
00000000000000000000000000000000000000