9 11
00000000000
00011011000
00011011000
00001010000
00101010100
00101010100
00110001100
00000000000
00000000000